1111111111111111111111111111111111111111111111111
10P0000000000000000011000000000000000C00000000G01
1000111110001111100011001111100011111000111110001
1000100010001000100011001000100010001000100010001
1000111110001111100011001111100011111000111110001
1000000000000000000000000000000000000000000000001
1001110011000111111111111111111111100011000111001
1000000011000000000000011100000000000011000000001
1111100011111000000000011100000000011111000011111
1000100011111000000000011100000000011111000010001
111110001100000000000000C000000000000011000011111
100010001100001111111111111111111110001100G010001
1000100000000010000000000000000000100000000010001
1111100000000010000G00000000000000100000000011111
1000100011100011111111111111111111100011100010001
1000100011100000000000000000000000000011100010001
1111100011100000000000000000000000000011100011111
1000100011100011111111111111111111100011100010001
1111100011100011111111111111111111100011100011111
1000000000000000000000001000000000000000000000001
1000000E00000000000000001000000000000000000000001
1000111111111100111111001001111110011111111110001
10G0000000011100000000000000000000011100000000001
1000000000011100000000000000000000011100000000001
1111110000011100011001111111001100011100000111111
10000000G000000001100000100000110000G000000000001
1000111111111111111111001001111111111111111110001
1000111111111111111111001001111111111111111110001
100000000000000000000000C000000000000000000000001
1111111111111111111111111111111111111111111111111