1111111111111111111111111111111
1P00000000011100000000001111111
1010000001111000110000100000101
1010000001111000110000100000101
101000C000000000100000011111111
1111111111111111111101111111111
1C000000000000E000000000000C001
1111111111111111111111111111111