1111111111111111111111111111111
10000P000001110000C000001111111
101000E001111000110000100000001
1010000C0000000010C000011111111
1111111111111111111111111111111